1111111111111111111111111
1000000000010000000000001
1010011101010010110111001
1000002100000010010121001
1011100100010010110101001
1110100000000010010101011
1000000111110000000001011
1011110101010111101000001
1010210101010100101011101
1010000000000100001010001
1010110111110101101011101
1010010100000100101012001
1011110110110111101011101
1000000000010000000000001
1111111111111111111111111