0000100001000000001000001
0010010000000000000000000
0000000000000010000000000
0000000000000000000000000
0000000002000000001000010
0100000000000000000000001
0001000100000010000200000
0000000000101000000000000
0000000000000000001000000
0001000000000000000000100
0000010000000000000000000
0000000010000001000000000
0001000000000000100000000
0000000000000000000000000
0000000001000000000001000
